11111111111111111
11111111111111111
11201000000001011
11003000000000011
11000300000000011
11000300000000411
11000300000000411
11000300000000411
11000300000000411
11000300000000411
11010100000000411
11111111111111111
11111111111111111
