111111111
100000021
101010001
131000001
131010101
111111111
